X,X,X,X,X,X,X,X,X
X,,,,,,,,X
X,,,,,,,,X
X,,,,,,V,O,E
X,,,,,V,H,,X
X,,,,V,H,,,X
X,,,T,H,,,,X
X,,,,,,,,X
X,X,X,X,X,X,X,X,X
