X,X,X,X,X,X,X,X,X
X,,,,,,,,X
X,,,,,,,,X
X,,,,,X,X,X,X
X,,,,X,,,O,E
X,,,,X,,T,,X
X,,,,H,T,T,,X
X,,,,X,,,,X
X,X,X,X,X,X,X,X,X
