X,X,X,X,X,X,X,X,X
X,,,,,X,,,X
X,,,T,,,,,X
X,X,V,,,,X,,X
X,,,,X,,H,O,E
X,,X,T,,,,X,X
X,,,T,T,X,,,X
X,,,X,,,,,X
X,X,X,X,X,X,X,X,X
