X,X,X,X,X,X,X,X,X
X,,,,,,,,X
X,,,,X,,,,X
X,,,T,X,,,,X
X,,,,H,,H,O,E
X,,,T,X,,,,X
X,,,,X,,,,X
X,,,,,,,,X
X,X,X,X,X,X,X,X,X
