X,X,X,X,X,X,X,X,X
X,,,,,,X,,X
X,,,,,,T,,X
X,,,,,,V,,X
X,X,X,X,X,,H,O,E
X,,,,,,V,,X
X,,,,,,T,,X
X,,,,,,X,,X
X,X,X,X,X,X,X,X,X
