X,X,X,X,X,X,X,X,X
X,,,,,,,,X
X,,,,X,,,,X
X,,X,,,,X,,X
X,,T,T,,V,H,O,E
X,,X,,,,X,,X
X,,,,X,,,,X
X,,,,,,,,X
X,X,X,X,X,X,X,X,X
