X,X,X,X,X,X,X,X,X
X,,,,,,,,X
X,,X,,T,,X,,X
X,,,H,,V,,,X
X,,,,X,,,O,E
X,,,V,,H,,,X
X,,X,,T,,X,,X
X,,,,,,,,X
X,X,X,X,X,X,X,X,X
