X,X,X,X,X,X,X,X,X
X,,,,X,,,,X
X,,,,X,,,,X
X,,H,,T,,X,,X
X,,X,,T,T,H,O,E
X,,H,,T,,X,,X
X,,,,X,,,,X
X,,,,X,,,,X
X,X,X,X,X,X,X,X,X
