X,X,X,X,X,X,X,X,X
X,,H,,H,,,,X
X,,,X,,,,,X
X,,X,,T,T,,O,E
X,,,X,,,,,X
X,,T,T,,,,,X
X,,,X,,X,,X,X
X,,,H,,H,,X,X
X,X,X,X,X,X,X,X,X
