X,X,X,X,X,X,X,X,X
X,,,,H,,,,X
X,,,,,,X,,X
X,X,T,T,T,T,H,O,E
X,,,,,,,,X
X,X,X,X,,,,,X
X,,,,,,,,X
X,,,,,,,,X
X,X,X,X,X,X,X,X,X
