X,X,X,X,X,X,X,X,X,X,X,X
X,X,,,,,,,,,X,X
X,,,X,X,,,X,X,,,X
X,,X,,,,,,,X,,X
X,,X,,X,T,V,X,,X,,X
X,,,,H,,,H,,O,,E
X,,,,H,,,H,,,,E
X,,X,,X,V,T,X,,X,,X
X,,X,,,,,,,X,,X
X,,,X,X,,,X,X,,,X
X,X,,,,,,,,,X,X
X,X,X,X,X,X,X,X,X,X,X,X
