X,X,X,X,X,X,X,X,X
X,,,X,,,,,X
X,,X,X,,,H,,X
X,,,X,,V,H,O,E
X,,T,,,,H,,X
X,,T,T,,X,,,X
X,,T,,,X,X,,X
X,,,,,X,,,X
X,X,X,X,X,X,X,X,X
