X,X,X,X,X,X,X,X,X
X,,,,X,,H,,X
X,,,,,H,V,,X
X,,,T,T,X,,O,E
X,,X,,T,,X,,X
X,,,,,,X,,X
X,,,X,,,,V,X
X,,,,,,,,X
X,X,X,X,X,X,X,X,X
