X,X,X,X,X,X,X,X,X
X,,,,,,,,X
X,,,,X,,X,,X
X,,,,,,,V,X
X,,,,T,X,,O,E
X,,,,,,,V,X
X,,,,X,,X,,X
X,,,,,,,,X
X,X,X,X,X,X,X,X,X
