X,X,X,X,X,X,X,X,X
X,,,,,,,,X
X,,T,,X,X,X,,X
X,,,X,,,H,O,E
X,,T,H,T,,V,,X
X,X,,X,,,H,V,X
X,,,,T,,,,X
X,,,,X,X,,,X
X,X,X,X,X,X,X,X,X
