X,X,X,X,X,X,X,X,X
X,,,,X,,,,X
X,,,,,H,,,X
X,,,X,,,X,,X
X,X,T,T,T,V,H,O,E
X,,,X,,,X,,X
X,,,,,H,,,X
X,,,,X,,,,X
X,X,X,X,X,X,X,X,X
