X,X,X,X,X,X,X,X,X
X,,,,X,,,,X
X,,X,,T,,X,,X
X,,H,,X,T,,,X
X,,,,H,,,O,E
X,,H,,X,T,,,X
X,,X,,T,,X,,X
X,,,,X,,,,X
X,X,X,X,X,X,X,X,X
