X,X,X,X,X,X,X,X,X
X,,,X,,,H,,X
X,,,,T,,V,,X
X,,,,X,,H,,X
X,,,X,,,V,O,E
X,,,,,X,,X,X
X,,,,,,X,,X
X,,,,,,,,X
X,X,X,X,X,X,X,X,X
