X,X,X,X,X,X,X,X,X
X,,,,,,,,X
X,,X,,,H,,,X
X,,,,,X,,,X
X,,T,X,,X,,O,E
X,,,,,X,,,X
X,,X,,,H,,,X
X,,,,,,,,X
X,X,X,X,X,X,X,X,X
