X,X,X,X,X,X,X,X,X
X,,,,,,,,X
X,,,,,X,T,,X
X,,X,,,H,,,X
X,,T,,X,V,H,O,E
X,,X,,,H,,,X
X,,,,,X,,T,X
X,,,,,,,,X
X,X,X,X,X,X,X,X,X
