X,X,X,X,X,X,X,X,X
X,,,,,,,,X
X,,X,V,X,V,X,,X
X,,T,,,,H,O,E
X,,X,T,,,X,,X
X,,T,,,,H,,X
X,,X,V,X,V,X,,X
X,,,,,,,,X
X,X,X,X,X,X,X,X,X
