X,X,X,X,X,X,X,X,X
X,,,X,,,,,X
X,,,H,,X,,,X
X,,X,T,,,,X,X
X,,,,X,V,T,O,E
X,,T,H,,,X,,X
X,,,X,,,,,X
X,,,,,X,,,X
X,X,X,X,X,X,X,X,X
