X,X,X,X,X,X,X,X,X
X,,,,,,,,X
X,,,,,H,V,T,X
X,,,,,X,,O,E
X,,,,,,X,T,X
X,,,,,,,,X
X,,,,,,,,X
X,,,,,,,,X
X,X,X,X,X,X,X,X,X
