X,X,X,X,X,X,X,X,X
X,,,,,,,,X
X,,T,X,,X,,X,X
X,,,H,,H,,,X
X,,T,,V,H,V,O,E
X,,,H,,H,,,X
X,,T,X,,X,,X,X
X,,,,,,,,X
X,X,X,X,X,X,X,X,X
