X,X,X,X,X,X,X,X,X
X,,,,,X,,,X
X,,,X,,T,,X,X
X,,,,H,V,,,X
X,,T,X,,T,,O,E
X,,,,H,V,,,X
X,,,X,,T,,X,X
X,,,,,X,,,X
X,X,X,X,X,X,X,X,X
