X,X,X,X,X,X,X,X,X
X,,,,,,,,X
X,,,,,X,,,X
X,,,,,H,,O,E
X,,,,X,,X,,X
X,,,,H,,T,,X
X,,,X,,X,,X,X
X,,,,,,,,X
X,X,X,X,X,X,X,X,X
