X,X,X,X,X,X,X,X,X
X,,,X,,H,,,X
X,,T,,H,V,,,X
X,,,H,V,,,O,E
X,,,V,,X,,,X
X,X,X,,,,X,,X
X,,,,,X,,,X
X,,,,,,,X,X
X,X,X,X,X,X,X,X,X
