X,X,X,X,X,X,X,X,X
X,,,X,,,,,X
X,,,,,X,,,X
X,,X,,V,,H,,X
X,,,T,,X,T,O,E
X,,,X,,,,,X
X,,,,X,X,,,X
X,,,,,X,,,X
X,X,X,X,X,X,X,X,X
