X,X,X,X,X,X,X,X,X
X,,,,,X,,,X
X,X,,,,,H,V,X
X,,,X,,H,V,O,E
X,X,,,H,V,,,X
X,,,H,V,,,,X
X,,T,T,,T,X,,X
X,,,,X,,,,X
X,X,X,X,X,X,X,X,X
