X,X,X,X,X,X,X,X,X
X,,,X,,X,,,X
X,,X,,,,X,,X
X,,T,,,,T,,X
X,,,X,T,X,,O,E
X,,X,,H,,X,,X
X,,,,T,,,,X
X,,,,H,,,,X
X,X,X,X,X,X,X,X,X
