X,X,X,X,X,X,X,X,X
X,X,,,X,,X,,X
X,,,,T,,T,,X
X,,V,V,X,,,O,E
X,,,,,X,,,X
X,X,,,X,,,,X
X,,V,,,,,,X
X,,,X,,,,,X
X,X,X,X,X,X,X,X,X
