X,X,X,X,X,X,X,X,X
X,,,,,,,X,X
X,,,,,,,,X
X,,,,T,T,X,,X
X,X,,,X,,,O,E
X,,X,,,H,,,X
X,,,,,V,X,,X
X,,,,X,,,,X
X,X,X,X,X,X,X,X,X
