X,X,X,X,X,X,X,X,X
X,,X,,,,,,X
X,,,,,,,,X
X,,,X,,X,,X,X
X,,T,H,T,H,T,O,E
X,X,,X,,X,,,X
X,,,,,,,,X
X,,,,,,X,,X
X,X,X,X,X,X,X,X,X
