X,X,X,X,X,X,X,X,X
X,,,,,,X,,X
X,,,X,,X,,,X
X,,T,H,,,V,,X
X,,,X,T,X,,O,E
X,,T,H,,,V,,X
X,,,X,,X,,,X
X,,,,,,X,,X
X,X,X,X,X,X,X,X,X
