X,X,X,X,X,X,X,X,X
X,,,,,,,,X
X,X,,,,,,,X
X,,,X,,,,,X
X,,T,,V,X,,O,E
X,,,X,,,,,X
X,X,,,,,,,X
X,,,,,,,,X
X,X,X,X,X,X,X,X,X
