X,X,X,X,X,X,X,X,X
X,,,,,,,,X
X,,,X,,,,,X
X,,,T,V,X,,,X
X,,X,,H,,,O,E
X,,,,X,,,,X
X,,,,,,,,X
X,,,,,,,,X
X,X,X,X,X,X,X,X,X
