X,X,X,X,X,X,X,X,X
X,,,,,,,,X
X,X,X,T,H,,X,,X
X,,,,T,H,,,X
X,,,X,,T,H,O,E
X,,,X,,,T,X,X
X,,,,,,,,X
X,,,,X,X,,,X
X,X,X,X,X,X,X,X,X
